%%%%%%%%%%
%P.......%        
%........%
%........%
%........%
%........%
%........%
%...... .%
%...... .%
%%%%%%%%%%